1111111111111111
100P0000C0000011
1110C011O000EC11
1111111111111111