11111111111
10000000P01
100000000E1
11111111111