11111
1P0C1
10101
1C111
11E11
