11111111111111
100P0000C00001
1000C00000E001
100000C0000001
11111111111111