111111111111111111111111111111
100P0000C000000000000000000001
1000C00000E0000000000000000001
100000C00000000000000000000001
100000C00000000000000000000001
100000C00000000000000000000001
100000C00000000000000000000001
100000C00000000000000000000001
100000C00000000000000000000001
100000C00000000000000000000001
100000C00000000000000000000001
111111111111111111111111111111