11111111111
10C00E00001
100C00P0001
11111111111