1111111111111111
100P0000C0000001
1110C01100E000O1
1111111111111111